O KZD+P  OOOOOOOOOOOOOOOOOOOO
O           OO              O
O    ZZ                     O
O        O  K  O     +      O
O        O     O      +     O
O OOOOOOOOOOO               O
O   D                       O
O                P          O
O                           O
OOOOOOOOOOOOOOOOOOOOO        