O  ZD+P  OOOOOOOOOOOOOOOOOOOO

O           OO              O

O    ZZ                     O

O        O     O     +      O

O        O     O      +     O

O OOOOOOOOOOO               O

O   D         K              O

O                P          O

O                           O
OOOOOOOOOOOOOOOOOOOOO                                 